Andrew	Miller      123156	 y      y       y       n       y       y       n       y       y       y
John	Doe     123156 	 y      y       y       n       y       y       n       y       y       y
John 	Smith       123156	 y      y       y       n       y       y       n       y       y       y
Jane	Deer        123156	 y      y       y       n       y       y       n       y       y       y
William	Clinton     123156	 y      y       y       n       y       y       n       y       y       y
George	Jones       123156	 y      y       y       n       y       y       n       y       y       y
Sarah	White       123156	 y      y       y       n       y       y       n       y       y       y
Bill	Able        123156	 y      y       y       n       y       y       n       y       y       y
Larry	Brown       123156	 y      y       y       n       y       y       n       y       y       y
Amanda	Ernst       123156	 y      y       y       n       y       y       n       y       y       y
Richard	Farmer      123156	 y      y       y       n       y       y       n       y       y       y
Sam	Green       123156	 y      y       y       n       y       y       n       y       y       y
Paula	Hamilton        123156 y      y       y       n       y       y       n       y       y       y
Jesus	Javiar      123156	 y      y       y       n       y       y       n       y       y       y
Christy	King        123156	 y      y       y       n       y       y       n       y       y       y
Bob	Bush        123156	 y      y       y       n       y       y       n       y       y       y
Jerry	Landers     123156	 y      y       y       n       y       y       n       y       y       y
Sally	Moore       123156	 y      y       y       n       y       y       n       y       y       y
Nancy	Nadler      123156	 y      y       y       n       y       y       n       y       y       y
Tina	Templar     123156	 y      y       y       n       y       y       n       y       y       y	